Country,total_content,movies,tv_shows,percentage,Market_Tier
United States,3291,2431,860,36.33,Tier 1: Saturated (500+ titles)
India,990,915,75,10.93,Tier 1: Saturated (500+ titles)
United Kingdom,722,467,255,7.97,Tier 1: Saturated (500+ titles)
Canada,412,286,126,4.55,Tier 2: Established (100-499 titles)
France,349,265,84,3.85,Tier 2: Established (100-499 titles)
Japan,286,103,183,3.16,Tier 2: Established (100-499 titles)
Spain,215,158,57,2.37,Tier 2: Established (100-499 titles)
South Korea,212,55,157,2.34,Tier 2: Established (100-499 titles)
Germany,199,157,42,2.2,Tier 2: Established (100-499 titles)
Mexico,154,101,53,1.7,Tier 2: Established (100-499 titles)
China,147,102,45,1.62,Tier 2: Established (100-499 titles)
Australia,143,84,59,1.58,Tier 2: Established (100-499 titles)
Egypt,110,97,13,1.21,Tier 2: Established (100-499 titles)
Turkey,108,80,28,1.19,Tier 2: Established (100-499 titles)
Hong Kong,102,97,5,1.13,Tier 2: Established (100-499 titles)
Italy,90,67,23,0.99,Tier 3: Growing (20-99 titles)
Brazil,88,59,29,0.97,Tier 3: Growing (20-99 titles)
Taiwan,85,15,70,0.94,Tier 3: Growing (20-99 titles)
Belgium,85,74,11,0.94,Tier 3: Growing (20-99 titles)
Argentina,82,64,18,0.91,Tier 3: Growing (20-99 titles)
Indonesia,80,77,3,0.88,Tier 3: Growing (20-99 titles)
Philippines,78,77,1,0.86,Tier 3: Growing (20-99 titles)
Nigeria,76,68,8,0.84,Tier 3: Growing (20-99 titles)
Thailand,65,43,22,0.72,Tier 3: Growing (20-99 titles)
South Africa,54,44,10,0.6,Tier 3: Growing (20-99 titles)
Colombia,45,17,28,0.5,Tier 3: Growing (20-99 titles)
Netherlands,45,37,8,0.5,Tier 3: Growing (20-99 titles)
Denmark,44,31,13,0.49,Tier 3: Growing (20-99 titles)
Ireland,40,28,12,0.44,Tier 3: Growing (20-99 titles)
Singapore,39,18,21,0.43,Tier 3: Growing (20-99 titles)
Sweden,39,29,10,0.43,Tier 3: Growing (20-99 titles)
Poland,36,28,8,0.4,Tier 3: Growing (20-99 titles)
United Arab Emirates,34,33,1,0.38,Tier 3: Growing (20-99 titles)
Norway,29,20,9,0.32,Tier 3: Growing (20-99 titles)
New Zealand,28,20,8,0.31,Tier 3: Growing (20-99 titles)
Russia,27,10,17,0.3,Tier 3: Growing (20-99 titles)
Lebanon,26,19,7,0.29,Tier 3: Growing (20-99 titles)
Malaysia,26,18,8,0.29,Tier 3: Growing (20-99 titles)
Chile,26,21,5,0.29,Tier 3: Growing (20-99 titles)
Israel,26,18,8,0.29,Tier 3: Growing (20-99 titles)
Pakistan,24,20,4,0.26,Tier 3: Growing (20-99 titles)
Czech Republic,20,14,6,0.22,Tier 3: Growing (20-99 titles)
Switzerland,17,16,1,0.19,Tier 4: Emerging (5-19 titles)
Uruguay,14,13,1,0.15,Tier 4: Emerging (5-19 titles)
Romania,12,12,0,0.13,Tier 4: Emerging (5-19 titles)
Luxembourg,11,10,1,0.12,Tier 4: Emerging (5-19 titles)
Austria,11,10,1,0.12,Tier 4: Emerging (5-19 titles)
Finland,11,7,4,0.12,Tier 4: Emerging (5-19 titles)
Greece,10,8,2,0.11,Tier 4: Emerging (5-19 titles)
Peru,10,10,0,0.11,Tier 4: Emerging (5-19 titles)
Saudi Arabia,10,6,4,0.11,Tier 4: Emerging (5-19 titles)
Hungary,9,8,1,0.1,Tier 4: Emerging (5-19 titles)
Bulgaria,9,9,0,0.1,Tier 4: Emerging (5-19 titles)
Iceland,9,7,2,0.1,Tier 4: Emerging (5-19 titles)
Jordan,8,7,1,0.09,Tier 4: Emerging (5-19 titles)
Serbia,7,7,0,0.08,Tier 4: Emerging (5-19 titles)
Qatar,7,7,0,0.08,Tier 4: Emerging (5-19 titles)
Kuwait,7,4,3,0.08,Tier 4: Emerging (5-19 titles)
Morocco,6,6,0,0.07,Tier 4: Emerging (5-19 titles)
West Germany,5,3,2,0.06,Tier 4: Emerging (5-19 titles)
Kenya,5,5,0,0.06,Tier 4: Emerging (5-19 titles)
Vietnam,5,5,0,0.06,Tier 4: Emerging (5-19 titles)
Cambodia,5,5,0,0.06,Tier 4: Emerging (5-19 titles)
Croatia,4,3,1,0.04,Tier 5: Untapped (< 5 titles)
Iran,4,4,0,0.04,Tier 5: Untapped (< 5 titles)
Portugal,4,4,0,0.04,Tier 5: Untapped (< 5 titles)
Ghana,4,4,0,0.04,Tier 5: Untapped (< 5 titles)
,4,4,0,0.04,Tier 5: Untapped (< 5 titles)
Zimbabwe,3,3,0,0.03,Tier 5: Untapped (< 5 titles)
Senegal,3,2,1,0.03,Tier 5: Untapped (< 5 titles)
Slovenia,3,3,0,0.03,Tier 5: Untapped (< 5 titles)
Malta,3,2,1,0.03,Tier 5: Untapped (< 5 titles)
Soviet Union,3,3,0,0.03,Tier 5: Untapped (< 5 titles)
Venezuela,3,3,0,0.03,Tier 5: Untapped (< 5 titles)
Ukraine,3,1,2,0.03,Tier 5: Untapped (< 5 titles)
Bangladesh,3,3,0,0.03,Tier 5: Untapped (< 5 titles)
Cayman Islands,2,2,0,0.02,Tier 5: Untapped (< 5 titles)
Iraq,2,2,0,0.02,Tier 5: Untapped (< 5 titles)
Georgia,2,2,0,0.02,Tier 5: Untapped (< 5 titles)
Guatemala,2,2,0,0.02,Tier 5: Untapped (< 5 titles)
Algeria,2,2,0,0.02,Tier 5: Untapped (< 5 titles)
Nepal,2,2,0,0.02,Tier 5: Untapped (< 5 titles)
Namibia,2,2,0,0.02,Tier 5: Untapped (< 5 titles)
Bahamas,1,1,0,0.01,Tier 5: Untapped (< 5 titles)
Bermuda,1,1,0,0.01,Tier 5: Untapped (< 5 titles)
Botswana,1,1,0,0.01,Tier 5: Untapped (< 5 titles)
Kazakhstan,1,1,0,0.01,Tier 5: Untapped (< 5 titles)
Jamaica,1,1,0,0.01,Tier 5: Untapped (< 5 titles)
East Germany,1,1,0,0.01,Tier 5: Untapped (< 5 titles)
Cuba,1,0,1,0.01,Tier 5: Untapped (< 5 titles)
Dominican Republic,1,1,0,0.01,Tier 5: Untapped (< 5 titles)
Cyprus,1,0,1,0.01,Tier 5: Untapped (< 5 titles)
Ecuador,1,1,0,0.01,Tier 5: Untapped (< 5 titles)
Afghanistan,1,1,0,0.01,Tier 5: Untapped (< 5 titles)
Angola,1,1,0,0.01,Tier 5: Untapped (< 5 titles)
Albania,1,1,0,0.01,Tier 5: Untapped (< 5 titles)
Armenia,1,1,0,0.01,Tier 5: Untapped (< 5 titles)
Azerbaijan,1,0,1,0.01,Tier 5: Untapped (< 5 titles)
Belarus,1,0,1,0.01,Tier 5: Untapped (< 5 titles)
Liechtenstein,1,1,0,0.01,Tier 5: Untapped (< 5 titles)
Latvia,1,1,0,0.01,Tier 5: Untapped (< 5 titles)
Lithuania,1,1,0,0.01,Tier 5: Untapped (< 5 titles)
Puerto Rico,1,0,1,0.01,Tier 5: Untapped (< 5 titles)
Paraguay,1,1,0,0.01,Tier 5: Untapped (< 5 titles)
Nicaragua,1,1,0,0.01,Tier 5: Untapped (< 5 titles)
Panama,1,1,0,0.01,Tier 5: Untapped (< 5 titles)
Malawi,1,1,0,0.01,Tier 5: Untapped (< 5 titles)
Mauritius,1,0,1,0.01,Tier 5: Untapped (< 5 titles)
Montenegro,1,1,0,0.01,Tier 5: Untapped (< 5 titles)
Mongolia,1,1,0,0.01,Tier 5: Untapped (< 5 titles)
Sudan,1,1,0,0.01,Tier 5: Untapped (< 5 titles)
Sri Lanka,1,1,0,0.01,Tier 5: Untapped (< 5 titles)
Somalia,1,1,0,0.01,Tier 5: Untapped (< 5 titles)
Slovakia,1,1,0,0.01,Tier 5: Untapped (< 5 titles)
Samoa,1,1,0,0.01,Tier 5: Untapped (< 5 titles)
Syria,1,0,1,0.01,Tier 5: Untapped (< 5 titles)
Uganda,1,1,0,0.01,Tier 5: Untapped (< 5 titles)
Vatican City,1,1,0,0.01,Tier 5: Untapped (< 5 titles)
