Country,2017-2018,2019-2020,2019,2020,Multi-Year_Growth_%,YoY_2019-2020_%
Nigeria,2,72,30,42,3500.0,40.0
Egypt,3,106,54,52,3433.33,-3.7
Philippines,7,71,39,32,914.29,-17.95
Lebanon,4,22,4,18,450.0,350.0
Poland,8,27,16,11,237.5,-31.25
United Arab Emirates,10,23,8,15,130.0,87.5
South Africa,18,34,10,24,88.89,140.0
Taiwan,20,36,24,12,80.0,-50.0
Japan,92,161,78,83,75.0,6.41
Italy,31,53,21,32,70.97,52.38
